30 15
##############################
#............................#
#............................#
#.....######.........######..#
#.....######.........######..#
#............................#
#............................#
#............##..............#
#............................#
#............................#
#..######...........######...#
#..######...........######...#
#............................#
#............................#
##############################
